11000000000000000000-
01000000000000000000-
01011110011110000000-
01010010010010000000-
01010010010011100000-
01010010010000100000-
01010010010000100000-
01010010010000110000-
01110011110000010000-
00000000000000010000