00000000000000100000-
00000000000000100000-
00000111100000100000-
00000100100000100000-
00000100100000100000-
00000100111111100000-
00000100000000000000-
00000100000000000000-
00000100000000000000-
00000100000000000000