11000000000000000000-
01000000000000000000-
01011110011110000000-
01010010010010000000-
01010010010011111111-
01010010010000000000-
01010010010000000000-
01010010010000000000-
01110011110000000000-
00000000000000000000