00100000000000000000!
00100000001111111100!
00000000000000011100!
00000000000000110000!
00000000000111100000!
00000000000100000000!
00001111111100000000!
11111000000000000000!
00000000000000000000!